XXXXXXXXXXXX
XX...X....AX
XX....B.BB.X
XXGG.XXB..XX
X.GG.X..XXXX
X.......XXXX
XXXXXXXXXXXX
