XXXXXXXXX
XX..GXG.X
X.B.XX..X
X.B.B..GX
X......AX
XXXXXXXXX
