XXXXXXXXXXXX
XX...X.....X
XX...X.GG..X
XXBBB.XGGXXX
X.B....AXXXX
X...X...XXXX
XXXXXXXXXXXX